%%%%%%%%%%%%%%%%%%%%%%%%%%%%%%%%%%%%%%%%%%%%%%%%%%%%%%%%%%%%%%%%%%%%%%%%%%%%%%%%%%%%%%%%%%%%%%%%%%%
% % %     % %   %       %   %       %         % % %       % % %     % %       % %     % % %   %   %
% % % %%%%% % %%% % %%%%%%% % %%%%%%%%% % %%% % % %%%%%%% % % % %%% % % %%% %%% %%%%% % % % %%%%% %
%           %   % %   % % % % %   %   % % %         %   % %   % %         % % %               % % %
%%%%%%%%%%% % %%% %%% % % % % %%% % %%%%%%%%% % %%%%% % % %%% %%% % %%% %%%%% % % %%% %%% %%% % % %
% %     % %   % %   % %             %   %   % % %   % %           %   % %   % % % %   %     %     %
% % %%%%% %%% % % %%% % %%%%%%% %%%%%%% % %%% %%% %%%%%%%%%%%%% %%%%%%% % %%% % %%% % % %%%%% %%% %
% %     %     %   % % %   %       %       %       %   %     % %   %   %     %   % % % % %       % %
% % % %%% %%%%%%% % % % %%%%% % %%%%% % %%%%% %%%%% %%% % %%% % % % %%% % %%%%%%% %%%%%%%%%%% %%% %
%   % % %   %   % %     %   % % % % % %         %   % % % % %   %   %   % % % %   % %   %     %   %
% %%% % %%% % %%%%%%% %%% %%% % % % % %%%%% %%% % %%% % % % %%%%% % % % % % % % % % %%% % %%% % %%%
% % %     %     %       %   % %   %   %       %   %   % %       % % % % % %   % %     %     % %   %
%%% % %%%%%%% %%%%%%%%% %%% % % %%% %%% % %%%%% %%%%% % % %%% %%%%%%%%%%% %%% % %%% % %%%%% %%% % %
% %     %         %   % %   % %   %   % %   %   %     % % %   %         %       % % % %       % % %
% %%%%% % %%%%% %%% %%% %%% %%%%%%% %%%%%%% %%%%% %%% %%%%% %%% % % % %%% % %%%%% %%% % %%%%%%%%% %
%         %     %         %   % % %       %   % % %         %   % % %     %     %     %   %     % %
%%%%% %%% %%% %%%%% %%% %%% %%% % % % % %%% %%% %%%%% %%% %%%%% %%%%%%%%%%% %%% %%%%%%% %%% %%%%% %
%       % % %   % %   %P  %     %   % % % %     % %   %         %   %   % %   %                 % %
%%%%%%% %%% % % % %%%%% % %%% % %%% %%% % % %%% % % %%%%% %%%%%%% % % %%% %%% %%%%%%% %%% %%% % %%%
% %         % %       % %     % %   %   %   %   % %     %         % %       % % %     %   % % %   %
% %%%%%%%%%%%%%%%%% % % % %%%%% %%%%%%% % % % %%% % % %%%%% %%%%% % % %%% %%%%% % %%%%% % % % %%%%%
%   %     %       % %   % %   % % %   % % % %       % %     %   % % % % %   % %     % % % %       %
% % %%%%% %%%%% %%%%% %%% % % %%% % % %%%%%%%%% %%%%% %%%%% %%% % %%% % %%% % % %%%%% %%% %%%%% %%%
% % %     %   % %   % %   % % % %   % % % % %   % %   %   %     %   % %       % %   %         %   %
% % % % %%%%% % %%% %%% %%% %%% % % % % % % % %%% %%% % % %%%%% % % %%% % %%%%%%% %%% % % %%% %%%%%
% % % %     % % %               % % %         % %   % % %       % %   % %   % % %   % % % %       %
% %%%%% % %%% % % % %%%%%%%%%%%%%%%%% %%% % %%% % % %%%%% %%%%% %%% % %%% %%% % % % %%%%%%% % % %%%
%       % % %     %   % %       %     %   % % % % % % %     %   %   %   %   %     % %   % % % %   %
% % % % %%% %%% % %%%%% %%% %%%%%%% %%%%% %%% % % % % %%%%% % %%% % % % % % %%%%% %%% % % %%% % %%%
% % % % % % %   %           %   %     %   %   %   %   %     % %   % % %   % %     %   %     % %   %
%%%%% %%% % %%%%%%%%%%%%% %%% %%%%% %%%%% % %%%%%%% %%%%% % %%%%% % %%% %%%%% %%% % %%%%% % %%%%%%%
%     % %     % %     % %     %     %   % %   %     %     %   %   % % % % %     %     % % %   % % %
%%%%% % % % %%% %%% %%% % % %%% %%% %%% %%% % % % %%% %%%%%%% % %%% % % % % %%%%% %%% % % %%%%% % %
%   %     %     %   %     % % %   % %       % % % %   %   % % % %     % %   %   %   % %   % %     %
%%% %%% %%% % % %%% % %%%%% % % %%% % %%%%% %%% %%%%% %%% % % %%% %%% %%%%%%%%% %%%%% % %%% %%%%% %
%         % % % %   %     %   % %   % %     %   %   %       % %     % %           % % %     %     %
%%%%%%% %%% %%%%%%% % %%%%%%% %%%%%%% %%% %%% % %%% % %%%%%%% %%%%%%%%% % %%%%% % % %%% %%%%%%% %%%
%     % % %     % % % %     % %     % %   % % % %     %     %     %     %   %   %   %             %
%%% % %%% % % %%% % % %%% %%% % %%% %%%%% % %%% %%% %%%%% %%% %%% %%%%% %%%%% %%% %%% % % %%%%%%%%%
%   % % % % %   %   % %       %   %                   % % %   %       %   % %   % % % % %     % % %
%%% %%% % % %%% %%% % %%% %%% % % %%%%% %%%%% % %%%%% % % % % %%% % %%%%% % % %%%%% %%%%%%%%% % % %
%   %         % %       %   %   % %   %   %   % %     %   % %   % %   % % %   %     % %       %   %
% % %%%%% % % % %%%%%%%%%%% % %%%%% %%% %%%%%%%%% %%% % %%%%%%%%% % %%% %%% %%%%% %%% % % %%% %%% %
% %     % % % % % %   %   % %   %     % % %   % % %         %   % %   % %       % %     % % %     %
%%%%% %%%%% %%%%% % % %%% %%%%% % %%% %%% % %%% %%%%% % %%%%% %%%%%%%%% %%% %%% % % %%%%%%% % %%% %
%   % % %     % %   % %         % % % %     % %     % %       %           %   %   %         %   % %
%%% % % % %%%%% % %%%%% %%%%% % %%% % % % %%% % %%% %%% % % % %%% %%%%%%% % % %%% % %%%%% % %%%%%%%
%         %   %         % % % %   % %   %     %   %     % % %     %         % % % % %     %       %
%%%%% % %%%%% % %%% %%%%% % %%% %%% % %%%%%%% %%%%% %%%%% %%%%%%% % % % %%%%% % % %%%%%%% %%%%%%%%%
% %   % % %   % %             %       %           %   %   %     % % % % %     %   %         %     %
% % %%% % %%% % % % % %%% %%%%%%% %%% %%% %%% %%%%% % % %%%%% %%%%%%% %%% % % %%% %%% %%%%% % % % %
%     %   %     % % % %     % %   %     %   %   %   % %       %     %   % % %   %   % % % %   % % %
% %%%%%%% %%% %%% %%% %%%%% % %%% % %%% % %%%%%%%%% %%% %%% % %%% % %%% %%%%%%% %%% %%% % % %%% %%%
%   %     %   %   % %   % %     % % % % %   %   %     %   % % %   %     % %   % %     % %   % %   %
% %%%%%%% %%%%% %%% %%% % %%%%%%% %%% %%%%%%%%% %%% %%%%%%% %%%%%%%%%%%%% % %%% %%% %%% %%%%% %%% %
% %       %   % %     %     %   % %         %         % %   %           %     % % % %       %     %
% %%%%%%% %%% % %%% %%% % %%%%% %%% %%% %%% %%%%%%%%% % % %%%%% %%%%%%%%%%% %%% % % % % %%% % % %%%
% %           % %   % % % %   % % %   %   %   %       %         %       %       % %   % %   % %   %
%%% %%%%% %%%%%%% % % % %%%%% % % % % %%% %%% %%%%% % % % % % %%% % %%%%% %%% % % % %%%%%%%%% %%%%%
%   %         %   %     %     %     % %   %     % % % % % % % % % %   % %   % % %     % %         %
% %%% %%%%% %%% % %%%%%%%%% % %%%%% %%%%% % %%%%% % % %%% % % % %%% % % %%% %%%%%%% %%% %%% %%%%%%%
%   %   % % %   %   % % %   % %       %   % % % %   % % % % %   %   %       %   %     %   %   %   %
%%%%% %%% % %%% %%% % % % %%%%% % %%%%%%% %%% % %%% %%% % %%% %%%%%%%%%%%%% %%% %%%%%%%%% %%% % % %
% % % %       % % %   %         %     %   %     % % %   % %           %                   %     % %
% % %%%%%%% % % % % % %%%%%%% %%% %%% % %%%%%%% % % % % % %%% %%% %%%%%%% %%%%%%%%%%%%% % %%%%%%% %
%   %       %   % % %         % % % % % % % %       % % %   %   %       % %       %   % % %       %
% %%%%%%%%%%% %%% % %%% %%%%% % % % % %%% % %%% %%%%%%% % %%% % %%%%% %%%%% %%%%%%% % % % %%%%% %%%
% %   %   %   %   %   % %   % %     %   %   %   %       %   % % % % % %         %   %   %         %
% %%% %%% %%% % % %%%%%%% %%% % %%% %%%%% %%%%% % %%%%%%% %%%%% % % % % % %%%%%%%%%%%%%%% % %%%%% %
% %   %         % %   %     % % %   %     %   %   %   % % % %     %   % % %   % %   %   % %     % %
% % % % %%% %%%%% %%% % % % %%%%% %%% %%%%% %%%%% % %%% %%% %%%%% %%% % % %%% % % %%%%% % %%%%% %%%
% % %   % % %   % %     % %       % %     %     % %           % % %   % % %       %     % %   % % %
% % %%% % %%%%% % % %%% %%% % %%% % %%%%% % % %%%%%%% %%%%% % % % % %%% %%% % %%% %%%%% %%% % % % %
%     %         % % %     % % % % %         %   %         % %   % %   %     %   % % % %   % % % % %
%%% % %%% %%%%%%% % %%%%% %%% % %%% % %%%%% %%%%% %%%%%%%%%%% % %%% % % %%% % %%%%% % %%% %%% % % %
%   % % %   %   % %   % %   % %   % % %     %   % %   %     % %     %   %   %       %       %   % %
% % %%% %%%%%%% % % %%% %%%%%%%%% % %%%%% %%%%% % %%% % %%%%%%%%%%%%% % %%%%% % %%%%%%% % %%% % % %
% % % %     %     % % %       %         %   %   %           % % %   % %     % % % % %   %   % %   %
%%% % %%%%% % %%%%% % % %%%%%%% %%% %%%%%%% % %%% % % %%% %%% % % %%%%% %%%%% %%% % % %%%%% %%%%%%%
%   %       %     %       %   %   % %             % % % %     % %     % %   %       % %     %   % %
%%% % % % % % %%%%%%%%%%%%% % %%% %%%%% %%%%%%%%%%% %%% % % % % % %%%%% % %%% % % % %%%%%%% % % % %
%     % % % % %     %   %   % %   %       %       %   %   % % %             % % % %         % %   %
% %%%%%%%%%%% % % % % % % %%%%%%%%%%% % %%%%%%%%% %%% %%%%% %%% %%%%% %%% % %%% %%% % % %%%%%%% %%%
%           %   % % % %   % %   % %   %       % % %     %     %   % % %   %   %   % % % %     %   %
% % %%%%% %%%%%%%%% %%%%% % % %%% %%%%%%%%% %%% % % %%%%%%%%% %%% % %%%%% % % %%% % %%%%%%% %%% %%%
% %     % % %     %     % %     % %       %   % %     % %   %   %     % % % %   % %     %         %
%%%%% %%% % %%%%% %%%%% % % %%% % % % %%%%% % % %%%%%%% % % % %%%%% %%% % %%%%% %%%%%%% %%%%%%% % %
%       %     %   % %   %   %   %   % %     %   % %       % % % %     %   %       % %   %   %   % %
%%% % %%% %%%%%%% % % % %%%%%%% % %%%%% %%% %%% % % % %%% %%% % % %%%%% %%% % % %%% % %%% %%% %%% %
% % %   %         %   %     % %     %     %   %   % %   % % % %   %   % %   % % %   % %     %   % %
% %%%%% %%%%%%% %%%%%%% % %%% % %%%%% %%%%%%%%%%%%% % %%%%% %%% %%%%% %%% % % % % %%%%% %%%%% % %%%
% %     % %   %   %   % %         %   % %   %   %   % %   %       % %   % % % %   %   %       % G %
% % %%%%% % %%% % % % %%%%%%%%% %%% % % %%% % % %%% %%% %%% %%%%%%% %%% % %%%%%%% % %%%%% %%%%%%% %
% % %         % % % %   %     % %   %   %     % %   %   %     % %   %       %         % %   % %   %
% % % %%% %%% %%% % %%% %%%%% % %%%%% % %%% %%%%% % %%% % %%% % %%% % %%%%%%% %%%%% %%% % %%% % %%%
%   % % % %   %     % % %       %     %       % % %         % %   % % %       % %         %       %
% %%% % %%% %%% %%% % %%%%% %%% % %%%%% %%%%%%% % %%% %%%%% %%%%% % %%% % %%%%% %%% %%%%%%%%% %%% %
%       %     %   %     %     % %   %   %         %   %       %         % %                 %   % %
%%%%%%%%%%%%%%%%%%%%%%%%%%%%%%%%%%%%%%%%%%%%%%%%%%%%%%%%%%%%%%%%%%%%%%%%%%%%%%%%%%%%%%%%%%%%%%%%%%%
