%%%%%%%%%%%%%%%%%%%%%%%%%%%%%%%%%%%%%%%%%%%%%%%%%%%%%%%%%%%%%%%%%%%%%%%%%%%%%%%%%%%%%%%%%%%%%%%%%%%
%             %       % %       %   % %     %   % % %               %   %           % %         % %
% %%%%%%%%% %%% %%% % % %%%%%%% %%% % % % %%% %%% % % % %%%%%%% % %%% % %%% %%%%%%% % %%% % % % % %
%   %         % %   %   %   %           %   % %       % %       % %   % %     % %     %   % % %   %
%%% %%%%% %%% % %%%%% % % %%% %%%%%%%%% %%%%% %%%%% % % %%%%%%%%% %%%%% % % %%% %%%%% %%% %%% %%%%%
%   % % % %       %   % % %         % %     % %     % % %   % % %         % %       % %     % %   %
%%%%% % % %%% %%%%%%%%% % %%%%% % %%% % %%%%% %%% % %%% %%% % % % % %%%%%%% %%% %%%%%%%%%%% %%% %%%
% %       % % %       % %   % % % %         %     % %   % % %     % %     %       %       %       %
% % %%% %%% %%%%%%% %%% % %%% %%% %%%%%%% %%%%%%%%%%%%%%% % %%% %%% %%% %%% % %%%%% %%%%%%%%% %%%%%
%   %       %   %       %   % % %     % % % %       %     %   % %     %   % %     % %     % % % % %
%%% %%% %%%%% %%%%% %%%%% % % % % %%% % % % % %%%%%%%%% %%% %%% % % %%%%% % % %%% % %%% % % % % % %
%     % %   % % % % %     %       % %   %   %   % % %       % % % %     % % % %   %     % %   % % %
%%%%%%%%% %%% % % % % %%%%% %%% %%% %%%%%%%%% %%% % %%% %%%%% %%%%%%%%% % %%% %%% %%% %%%%%%% % % %
%     %     %             % %     %       %   % %   % %     %       %       % % % %   %     %     %
%%% % % %%%%%%% %%%%% %%%%%%%%%%% % %%%%% %%% % % % % % % %%%%% %%%%% %%%%%%%%% %%% % % % % % % %%%
% % % %       %     %   %       % % % %   %     % %   % %     % % %   %   %   %   % % % % %   %   %
% %%% %%% %%%%% % %%%%% %%%%% % %%% % % %%%%% % %%% %%%%% % % % % % % % %%% %%%%% %%% % % % %%% % %
% %     %   %   % % %   %     % %     % %     %           % % % % % %       %     %     % % %   % %
% % %%% %%% % %%%%% % %%% % %%% % %%%%%%% %%%%% %%% %%% %%% %%% % %%%%%%%%% %%% % % %%%%% %%%%% %%%
%   %   %     %   % % % % % %     %         %   %     %   % % %       % % %   % %     %     % % % %
%%%%% % % % % %%% % %%% %%% %%% %%% %%%%% % %%% %%% %%%%% % % %%%%% %%% % % % % %%% %%%%%%%%% % % %
% %   %   % % %     % % % % % %     %   % %   %   %   %   %   %     %   %   %   % %     %     %   %
% % %%%%% %%%%%%% % % % % %%% % %%%%% % % % % % % % %%%%%%% % % %%% % % % %%%%%%% %%% %%% %%% % % %
%   %       %     % %     %     %     %   % % % % %       % %   %     %   %         %   % %   % % %
%%% % % % %%%%%%% % %%% %%% %%% % % %%%%% % %%%%%%% %%%%% %%%%% %%%%%%% % % % %%%%%%%%%%%%% % % %%%
%   % % %   %     % %   %   %   % %   %   %   %   % % %       % % % %   % % %     %     %   % % % %
% %%%%% % % % % %%%%%%% %%%%%%% %%%%%%% % %%% % %%%%% %%%%%%% %%% % % %%%%%%% %%%%%%% %%% %%%%% % %
%     % % % % %   % %   %   %     % %   % % % %             %   %   %         %   % %   %     %   %
%%% %%%%% %%%%%%% % %%% % %%% % %%% % %%% % %%% %%% % %%%%%%%%%%% %%% %%%%%%% % %%% % %%%%% %%% %%%
%   %     %   %         %     %   % % % % %   % %   %   %         %   %     % %     %   % % %     %
%%% %%%%% % %%%%% % %%%%%%%%%%% % % % % % % %%% % %%%%%%% %%%%%%%%%%% %%% %%% %%% %%% %%% % % %%%%%
% %     % %       %     %       % %   %   %   % %   % %                 %   %       % %     %     %
% % %%%%% %%% %%%%% %%%%% %%% %%% %%%%%%% %%% % % % % %%%%%%%%%%%%%%%%% %%% % % %%%%% % %%% % % %%%
%   %           %     % % %     %   %   %       % %     % %       % %   %   % % %   %     % % %   %
% % %%%%%%%%% %%%%% %%% %%% % %%% % % %%%%% % %%%%%%% % % %%% % % % %%% % %%%%%%% % % % % % %%%%%%%
%P%   %   %     % % % %   % % % % %     %   %   %     % %     % %         %   %   % % % % %       %
%%% % %%% % %%% % % % %%% %%%%% %%% % % %%%%% % %%% %%%%%%%%%%%%% %%% %%% % %%%%% %%% %%% %%%%% %%%
% % %     % % %   %         %     % % %   % % %   %     %   %     % % %       % %   %   % %     % %
% %%% %%%%% % %%% % %%% %%%%% % %%%%%%%%%%% % % % %%% %%% % %%%%% % % % %%%%%%% % % % % %%%%% %%% %
% % % %     %   % %   % % %   % %     %     % % %   % %   %         % %   %       %   %     % %   %
% % % % %%% %%% % %%%%% % %%% %%% %%%%%%%%% %%% %%% %%% %%%%%%%%%%%%%%%%% %%%%% %%%%% % % %%%%% %%%
%     % % % %   % % %   % % %     %   %   %       %   % % %     % %   %       %     % % % % %   % %
% %%% % % % % %%%%% % % % % % % % %%% % %%%%%%%%% %%%%% % %%%%% % % %%% % %%% %%%%% %%% %%% %%% % %
%   % % %     %     % % %   % % % % % % %   % %     % %       %   % %   % %   %     % % %       % %
%%%%% %%%%%%% % % %%% % % %%%%% %%% % % % %%% %%% %%% %%% %%% %%% % %%%%% % %%%%% % % %%% %%% % % %
%         % %   % % % %   % %   % % %   %               %   % %         % %   %   % %       % %   %
%%%%%%%%% % % %%%%% %%% % % %%% % % %%% % % % %%% %%% % % %%% %%% % % %%% % % %%% % %%% %%%%% %%% %
%           % %   %     %               % % %   % %   % % %   % % % %     % %   % % %   % %     % %
% % %%% %%%%% %%% %%% %%%%% %%% % % %%%%% % %%% %%%%%%% % %%% % %%% % % %%%%%%%%% %%%%% % %%% % %%%
% % %     %   % %   %   % % % % % %       % %     % % % %   %     % % % % % %     % % %   % % %   %
%%% %%% %%%%%%% % % % %%% %%% %%%%% %%% %%%%%%%%%%% % %%%%%%% %%%%%%%%% % % %%%%% % % % %%% % % %%%
% % % %   %       %   %   %   %       % %   %   %           %       %       %           %     % % %
% % % % %%% %%%%%%% %%% %%% % %%% %%%%% % % % % %%% % %%%%%%% % %%% %%% % %%%%%%%%% % % %%%%%%% % %
%     %   %     %           %   %   %     % % % % % % % %     %   % % % %       %   % %   % %     %
%%% %%% % %%%%%%%%%%%%% %%% %%%%% %%% %%%%% %%% % %%% % %%%%% %%%%%%% %%% %%% %%% % %%% % % %%%%% %
%   % % % %   % %     %   %   % %   %     %   %     %       % %   %   %   %       %   % %   %   % %
%%%%% %%% %%% % %%%%% %%% %%% % % % %%% %%% %%%%% % %%%%% %%%%%%% %%% %%%%%%% % %%%%%%%%%%% %%% % %
%       %   %   % %   %     % %   %   % %   %   % %       %   % %         %   % %   % %     %   % %
%%%%% %%% % % % % % %%%%% %%% %%% %%% %%% %%%%% % % % %%%%% %%% %%%%%%% %%% % %%% %%% %%% %%% % %%%
%   %   % %   % %     % %   %   %   % %     %     % % % %     %   %         %   %         %   %   %
% %%%%% %%%%% % % %%% % %%%%%%% % %%% %%% % %%%%% %%%%% %%% % %%% % % %%% %%% %%%%% %%% %%% % %%% %
%   % %     % % % %           % % %   % % %     %   % %     %       % %     %   %   % %     %   % %
% % % % %%% % % %%%%%%% %%% %%%%%%%%% % %%%%%%%%% %%% %%% % % %%%%%%% %%% %%%%% % % % %%% %%% %%% %
% %       % % % % % % %   % % % % %   %         %   %     % %     % % %     % % % %   % %   % %   %
%%% %%%%% % % %%% % % % % %%% % % % %%%%% %%% %%% %%% % %%%%% %%%%% % %%%%%%% % % %%%%% %%% %%% % %
%     %   %     %   %   %   % %         % % % % % %   %   %   %     %     %     %   %       %   % %
% % %%%%%%% %%%%% %%% %%%%% % % % %%% %%%%% % % % %%% %%%%%%% %%% % % %%%%%%%%%%% % %%%%% %%%%%%%%%
% % %   %         % %   %     % %   %   %     %   % %       % % % % % %       %   % % %   %       %
%%% % %%% % % % %%% %%% %%%%% %%% % %%%%%%% %%%%% % %%%%% % %%% % %%%%% %%%%% %%% %%% %%%%%%%%% %%%
% %   %   % % %   %   % %     %   % %   %     %         % % % %   %   %   % %   %   %       %     %
% % %%%%% %%%%%%%%%%% %%%%% %%% %%% %%% %%%%% %%%%% %%%%% % % %%% % %%%%%%% % %%%%% % % % %%% % % %
% %   %               % % % % %   % % %     %       % %   %       %             %     % % % % % % %
% %%%%%%%%%%%%%%%%% %%% % % % % %%% % %%% % % %%% %%% % %%%%%%%%%%% %%%%%%%%% %%%%%%%%% % % %%% %%%
% %   %     % % %   % % % %   % %   %     % %   %       %     % % %   %   % % %         % % %   % %
% %%% % %%%%% % %%%%% % % % %%% %%%%% % % %%% % %%% %%%%% % %%% % % %%% %%% % %%%%%%% %%% % % %%% %
%   %   %   % % %   %             %   % %     % %   % %   % %     % %       %           % % %     %
% %%% % % %%% % %%% % %%%%% % %%%%%%% %%%%% %%%%%%% % %%%%% %%%%% %%% %%% %%% % % %%%%%%%%% %%% %%%
%   % % % % %   %   % %   % %     %   %   % %   % % %             % % %     % % % %   % %   %     %
%%% % %%% % % %%% %%% % %%%%%%%%% %%%%%%% %%% % % % %%%%% %%% %%% % %%%%% %%% %%%%% %%% % %%%%% %%%
%     %       %   %   %   %       %     %     % %       %   % %       %   %   % %   % %           %
%%%%% %%% % %%%%% % %%%%% %%% %%%%%%% %%%%% %%%%%%% % %%% % % %%%%%%%%% %%%%% % % % % %%% %%% % % %
%   %     % %   %         %     % %   %   %         %     % % % %     %           %   %   %   % % %
% % %%% %%%%% % % %%%%%%%%%%%%% % %%% % %%% %%% %%%%%%%%%%% %%% % %%%%%%%%% % % %%% %%%%% % %%% %%%
% %     %     %         %     % % %   %     % %   %   %       %     %   %   % % % %       %   %   %
%%%%% %%%%%%% %%%%% %%%%% %%%%%%% % %%% %%%%% %%%%% % %%%%% % %%%%% %%% %%%%% % % %%%%% % %%%%%%%%%
% %       % %   %   %   %           %     %       % % %   % % %   %   %     % %     %   % %     % %
% %%%%% %%% % % %%% %%% % %%% %%% %%% % %%% %%%%% % % %%% %%%%%%% % %%% %%%%%%% %%%%% % %%% % % % %
%   %         % % %     % %   %       %       %     %   %       % % % %       %   % % % %   % % % %
%%% % % %%%%%%%%% % % %%% %%% %%%%% %%%%%%%%% %%%%% % %%% % % %%% % % %%% % %%%%%%% %%%%% %%%%%%% %
% %   % % %   %   % % % %   % %   %   % % % %   %   %     % %     %   %   %           %     %     %
% % % %%% % %%%%% % %%% %%%%% %%% %%% % % % % %%% % %%% % % %%%%% % %%%%%%% %%%%% %%%%%%% %%% % % %
%   %     %   %   %     % %   %   % % %   % % % % % %   % % %   %   %         % % %   %   %   % % %
%%%%% % %%% %%% %%% %%% % % %%%%% % % % %%% % % %%% %%%%% %%% %%% %%% % %%%%% % % % %%% %%% % % %%%
%   % %           %   % % % %   %   % % %       % % %  G  %           % %   % %             % %   %
%%% % %%%%%%% % %%% %%%%% % %%% % %%%%% %%%%%%% % % % % % % %%% %%%%%%% %%% %%%%% % % %%%%%%%%%%% %
%   %   %   % %   %     %         % %   %   %   % % % % % % % % %       %       % % % % %   %     %
% % % %%% %%% %%%%%%% % %%%%%%% %%% % % % %%% %%% % %%% %%% % %%% % %%%%%%% %%% % %%%%% % %%% %%% %
% %   %           %   % %         %   %           %   %   %     % %   %     %               % %   %
%%%%%%%%%%%%%%%%%%%%%%%%%%%%%%%%%%%%%%%%%%%%%%%%%%%%%%%%%%%%%%%%%%%%%%%%%%%%%%%%%%%%%%%%%%%%%%%%%%%
