%%%%%%%%%%%%%%%%%%%%%%%%%%%%%%%%%%%%%%%%%%%%%%%%%%%%%%%%%%%%%%%%%%%%%%%%%%%%%%%%%%%%%%%%%%%%%%%%%%%
%                                                                   %                 %     % % % %
%%%%%%%%%%% %%%%%%%%%%%%%%%%%%%%%%%%%%%%%%%%%%%%%%%%%%%%%%%%%%% %%%%% %%%%%%%%%%%%%%%%% % % % % % %
%             %                                       %             % %       %       % % % % % % %
%%%%%%%%%%% %%%%%%%%%%%%%%%%%%%%%%%%%%%%%%%%%%%%% %%%%% %%%%%%%%%%%%% %%% %%%%% %%%%%%% % %%% % % %
%                                                     %                               % %   % %   %
%%%%%%%%%%%%%%%%%%%%%%%%%%%%%%%%%%%%%%%%%%%%%%%%%%%%%%%%%%%%%%%%%%%%%%%%%%%%%%%%%%%%% % % % % % % %
%   % % % %   %   % % % %             %P%   %   % % % %   %   % % % % % % % % % % % % % % % % % % %
% % % % % % % %%% % % % %%% %%%%%%%%%%% % % % % % % % % % %%% % % % % % % % % % % % % % % % % % % %
% %       % % %   % % % %               % % % % %   %   % %     % % % % % % % % % % % % % % % % % %
% % % % % %%% %%% % % % % %%%%%%%%%%%%% % %%% %%%%% % % %%% % % % % % % % % % % % % % % % % % % % %
% % % % % %   %   % % % %             %         % % % % % % % %   % % % % % % % % %   % % % % % % %
% % % % % % % % %%% % % %%%%%%%%%%%%%%%%%%% %%%%% % % % % %%% %%%%% % % % % % % % % % % % % % % % %
% % % % % % % % % % % % %           %           % %   % % % % % % % % % %   % % % % % % % % % % % %
% % %%%%% % % % % % % % %%%%%%%%%%% % % % %%% % % % % % % % % % % % % % % % % % % % % % % % % % % %
% % % % % % % % % % % %             % % %   % % % % % % % % % %   % % % % % % % % % % % % % % % % %
% % % % % % % % % % % % %%%%%%%%%%% %%% %%% %%%%% % % % % % % % % % % % % % % % % % % % % % % % %%%
% %   % % % % % % % % % %               %       % % % %   % % % % % % % % % % % % % % % % %       %
% % % % % % % % % % % % %%%%%%%%%%%%%%%%%%%%%%%%% % % % % % % % %%% % % % % % % % % % % % % % % % %
% % %   % % % % % % % % % % % % % % %         % % % % % % %       % % % % % % % % % %   % % % % % %
% % % % % % % % % % % % % % % % % % %%%%% %%% % % % % % %%% %%%%%%% % % % % % % % % % % %%%%% % % %
% % % % % % % %   % % % % % % % % %     % %   % % % % % % % %     % % % % % % % % % % %     % % % %
% % % % % % % % % % % % % % % % % % % % % % %%% % % % % % % %%%%% % % % % % % % % % %%%%%%%%%%%%% %
% % % % % % % % % % % % %   % % % % % %   %     % % % % % % %     %   % % % % % % % % % % % % % % %
% %%%%% % % % % % % % % % %%% % % % %%%%%%%%%%% % % % % % % %%% %%% % % % % % % % % % % % % % % % %
% %     % % % % % %   % % % % % %   %     %     %   % %     %   % % % % % % % %   % % % % % % % % %
% %%% % % % % % % % % % % % % % % % % %%%%%%% %%% % % % % % % % % % % % % % % % % % % % % % % % % %
% %   % % % %   % % % %     %   % % %           % % % % % %   %   % % % % %   % % % % % % % % % % %
% %%% %%%%%%% %%%%% % % % % % % %%% %%%%% %%%%%%% % % % %%%%%%%%%%% % % % % % % % % % % % % % % % %
% %     %   %   % % % % % % % % % % %           % % % %             % % % % % % % %   % % % % % % %
% % % %%% % % %%% % % % %%% %%% % % % %%%%%%%%%%% %%%%%%%%%%%%%%%%% % % % %%%%% % % % % % % % % % %
% % %     %       % % % %       %   %           %   %             % % %       % % % % % % % % % % %
% %%%%%%% %%%%%%% % %%% %%% %%%%%%%%% %%%%%%%%%%% % % %%%%%%%%%%%%% % % %%% %%% % % % % % % % % % %
% %       %         %   % %                     % %               % % % %   % % % % % % % % % % % %
%%%%%%% %%%%%%%%%%% % % % %%% %%%%%%%%% %%%%%%%%%%%%%%%%%%%%% %%%%% % % % %%% % % % % % % % % % % %
% %   %   %       % % % %       %               %                 % % % % % % % % % % % % % %   % %
% %%% % % %%% %%%%% % %%%%%%%%%%%%%%%%%%%%%%% %%%%%%%%%%% %%%%%%%%%%% % % % % % % % % % % % % % % %
%   % % %         % % % % % % %   %   %     % % % % % % % %     % % % % % % % % % % % % % % % % % %
% % % % %%%%%%%%%%% % % % % % % %%% % %%% % % % % % % % % % %%% % % % % % % % % % % % % % % % % % %
% %   %           % % % % %   % %   % %   % % % % %   %   %   % %   % % %   % % % % % % % % % % % %
% % %%%%%%%%%%%%% % % % % % % % % % % %%% % % % % % % % % %%%%% % %%% % % % % % % % % % % % % % % %
% %   %     %     %   % % % %     % % %   % % %   % % % % % % % % % % % % %   % % % % % % % % % % %
% % % % %%%%%%%%% % % % % % %%%%%%% % % %%%%% % % % % % % % % % % % % % % %%%%% % % % % % % % %%% %
% % %             % % % % % %     % % %       % % % % % % %   % % % % % %   % % % % % % % % % % % %
%%%%% %%%%%%%%%%%%%%% % % % % %%%%% % %%% % % % % % % % % % % % % % % % % % % % % % % % % % % % % %
% %   % % % % % % % % % % % %       % %   % % % % % % % % % % % % % % % % % % % % % % % % % % % % %
% % % % % % % % % % % % % % % % %%% % %%% % % % % % % % % % % % % % % % % % % % % % % % % % % % % %
%   % % %   % %   % % % % % % %   % %     % % % % % % % % % % % % % % % % %   % % % % %   % % % % %
% % % % % % % % % % % % % % %%%%% %%%%%%%%%%% % % % % % % % % % % % % % % %%% % % % % % % % % % % %
% % % % % % %   % % % % % % %               %   % % % % % % % % % % %   % % % % % % % % % % % %   %
% % % % % % % % % % % % % % %%%%%%%%%%%%%%%%% % % % % % % % % % % % % % % % % %%% % %%% % % % % % %
% % % % % % % % % % % %   %                 % % % % % % %   %   % % % % % % % % % % % % % % % % % %
% % % % % % % %%% % % % % %%%%%%%%%%%%%%%%%%%%% % % % %%% %%%%% % % % % % % % % % % % % % % % % % %
% % %   % %     % % % % % %       %       % % % %   % %   % % %     % % %   % %   %   % % % % % % %
% % % % % %%% %%%%% % % %%%%%%% %%%%% %%%%% % % % % % % % % % % % % % % % % % % % % % % % % % % % %
% % % %   %       % % %   %                     % % % % % %     % % % % % % % % %   % % % % % % % %
% % % % % % %%% % % % % % %%%%% %%% %%%%%%%%% % % % % %%% %%%%%%%%%%% % % % % % % % % % %%% % % % %
% % % % % %   % % % % % % %       % %   % % % % % % % % % %       % % % % % % % % % % %   % % % % %
% % % % % %%% % % % % % % %%%%%%% % %%% % % % % % % % % % % %%%%%%% % % % % % % % %%% % % % % % % %
% % % % % %   % % % % % % % %   % %         % % % % % %         % % % % % % % % % %   % % % % % % %
% % % % %%%%%%%%%%% % % % % %%% % % %%%%% % % % % % % % % % %%% % % % %%%%% %%%%% %%%%% % % % % % %
% % % % % %   %   % % % % %     % % %     % % % % % % % % % % % % % % %     % %       % % %     % %
% % % % % %%% % %%% % % % % % % % % %%%%%%% % % % % % % % % % % % % % %%%%% % %%%%% % % % % % % % %
% % % %           % % % % % % %   % %       % % % % % % % % % %   % % % %     %     % % % % % % % %
%%%%% %%% %%%%%%% % % % %%%%%%%%%%%%%%%%%%%%% %%% % % % % % % % % % % % %%% % %%%%%%% % % % % %%% %
%     %   %       % % %   %                   % % % % % % % % % % % % %     % % %   % % % % %   % %
%%% %%%%%%%%%%%%%%% % % % %%% %%%%%%%%%%%%%%% % % % % %%% % % % % % % % % % % % %%% % % % % % %%% %
% % % %     % %   % % % %     %   %         % % % % % %   %   % % % % % % % %         % % % % % % %
% % % % %%% % % % % % % %%%%% % %%%%%%%%% %%% % % % % % % %%% %%%%% % % %%%%% % % %%% % % % % % % %
% % % %   %   % % % % % % %   %             % % % % % % % %     %   % %     % % %   % % % % % % % %
% % % % %%%%%%% % % % % % %%% %%%%%%%%%%% %%% % % %%%%% % %%% %%% % %%%%%%%%%%%%% %%%%% % % % % % %
% % % %         % % % %   %                 %   %     % % %       % % %               % % % % % % %
% % % %%%%%%%%% % % % % % %%%%%%%%%%%%% %%%%%%% %%% %%% %%%%%%%%%%%%% %%% %%%%%%%%%%% % % % % % % %
%     %         % % % % % % %         %       % %     %             % %       % %   % % % % % % % %
%%%%% %%%%%%%%% %%% % % % % %%%%%%% %%% %%%%% % %%% %%%%%%%%%%% %%%%% % % % %%% % %%% % % % % % % %
% %   %   %     % %   % % %             %     % %               %   % % % %         % % % % % % % %
% %%% %%% % %%%%% % % % % %%%%%%%%%%%%%%% %%%%% % % % % %%% %%% %%% % % % %%%%%%%%% % % % % % % % %
%                 % % % % %                   % % % % % %   %       % % % %         % % % % % % % %
%%%%%%%%%%%%% %%%%%%%%%%%%%%%%%%%%%%%%%%%%%%%%%%%%%%%%%%%%%%%%%%%%%%% %%%%%%% %%%%%%% %%% % % % % %
%                                                                   % %             % %   % % % % %
%%%%%%%%%%%%% %%%%%%%%%%%%%%%%% %%%%%%%%%%%%%%%%%%%%%%%%%%%%%%% %%%%% % %%%%% %%%%%%% % %%% % % % %
%                     %                                     %       %     %         % %     %   % %
%%%%%%%%%%%%%%%%%%%%%%%%%%%%%%%%%%%%%%%%%%%%%%%%%%%%%%%%%%%%%%%%%%%%%%%%%%%%%%%%%%%%%%% %%%%%%%%%%%
%         %                     %               %               %           %     % % % % %       %
%%% %%%%%%%%%%%%% %%%%%%%%%%%%%%%%%%%%%%%%%%% %%% %%%%%%%%%%%%%%%%% %%%%%%% %%% % % % % % %%% %%%%%
%                               %               %               %   %       % % % % %   %       % %
%%%%%%%%%%%%%%%%%%%%%%%%%%% %%%%%%%%%%%%% %%%%%%%%%%%%%%% %%%%%%%%%%% %%%%%%% % % % % % % % %%%%% %
%                                                                               % %   % % % % %   %
%%%%%%%%%%%%%%%%%%%%%%%%%%%%%%%%%%%%%%%%%%% %%%%%%%%%%%%%%%%%%%%%%%%%%%%%%%%% % % %%% % % % % % % %
%                                               %                         % % % % % % % % % %   % %
%%%%% %%%%%%%%%%%%%%%%%%%%%%%%%%%%%%%%%%%%%%%%% % %%% %%%%%%%%%%% %%%%%%%%% %%% % % % % % % % %%% %
%                                         %     % %   %                     % % %     %   %     % %
%%%%%%%%%%%%%%%%%%%%%%%%%%%%%%%%% %%%%%%%%% %%%%%%%%%%%%%%%%%%%%% %%%%%%%%%%% % % % % %%%%%%% %%%%%
%                                         %     % %                         %   % % % % % %       %
%%%%%%%%%%%%%%%%%%%%%%%%%%%%% %%%%%%%%%%%%% %%%%% % %%%%%%%%% % %%%%%%%%%%%%%%%%%%% %%% % % %%%%%%%
%                                         %           %       %             %         %   %       %
%%%%%%%%%%%%%%%%%%%%%%%%%%%%%%%%%%%%%%%%%%%%%%%%%%%%%%%%%%%%%%%%%%%%%%%%%%%%%%% %%%%%%%G%%% % %%%%%
%                                                                                     %     %     %
%%%%%%%%%%%%%%%%%%%%%%%%%%%%%%%%%%%%%%%%%%%%%%%%%%%%%%%%%%%%%%%%%%%%%%%%%%%%%%%%%%%%%%%%%%%%%%%%%%%
